{
  "1": "է",
  "2": "թ",
  "3": "փ",
  "4": "ձ",
  "5": "ջ",
  "6": "ւ",
  "7": "և",
  "8": "ռ",
  "9": "չ",
  "0": "ճ",
  "-": "-",
  "=": "ժ",
  "q": "ք",
  "w": "ո",
  "e": "ե",
  "r": "ր",
  "t": "տ",
  "y": "ը",
  "u": "ւ",
  "i": "ի",
  "o": "օ",
  "p": "պ",
  "[": "խ",
  "]": "ծ",
  "\\": "շ",
  "a": "ա",
  "s": "ս",
  "d": "դ",
  "f": "ֆ",
  "g": "գ",
  "h": "հ",
  "j": "յ",
  "k": "կ",
  "l": "լ",
  ";": ";",
  "'": "'",
  "z": "զ",
  "x": "ղ",
  "c": "ց",
  "v": "վ",
  "b": "բ",
  "n": "ն",
  "m": "մ",
  ",": ",",
  ".": "։",
  "/": "/",
  "!": "Է",
  "@": "Թ",
  "#": "Փ",
  "$": "Ձ",
  "%": "Ջ",
  "^": "Ւ",
  "&": "ԵՎ",
  "*": "Ռ",
  "(": "Չ",
  ")": "Ճ",
  "_": "—",
  "+": "Ժ",
  "Q": "Ք",
  "W": "Ո",
  "E": "Ե",
  "R": "Ր",
  "T": "Տ",
  "Y": "Ը",
  "U": "Ւ",
  "I": "Ի",
  "O": "Օ",
  "P": "Պ",
  "{": "Խ",
  "}": "Ծ",
  "|": "Շ",
  "A": "Ա",
  "S": "Ս",
  "D": "Դ",
  "F": "Ֆ",
  "G": "Գ",
  "H": "Հ",
  "J": "Յ",
  "K": "Կ",
  "L": "Լ",
  ":": ".",
  "\"": "\"",
  "Z": "Զ",
  "X": "Ղ",
  "C": "Ց",
  "V": "Վ",
  "B": "Բ",
  "N": "Ն",
  "M": "Մ",
  "<": "«",
  ">": "»",
  "?": "՞"
}
